1000,20
2,0,0,1,0,0,0
0,0,0,0,0,0,2
0,1,0,1,0,0,3
0,2,0,0,0,1,8
0,3,0,1,0,0,9
0,4,0,0,0,1,1
1,0,0,1,0,0,1
1,1,0,1,0,1,4
1,2,0,1,0,1,7
1,3,0,1,0,1,1
1,4,0,1,0,1,1
2,1,0,0,0,1,5
2,2,0,1,0,0,6
2,3,0,0,0,1,1
2,4,0,0,0,0,1